year,team,win,loss,W-L%,home_w,home_l,road_w,road_l,wildcard_w,wildcard_l,division_w,division_l,championship_w,championship_l,world_series_w,world_series_l,organization
2018,Arizona Diamondbacks,82,80,0.506,40,41,42,39,0,0,0,0,0,0,0,0,mlb
2018,Atlanta Braves,90,72,0.556,43,38,47,34,0,0,0,1,0,0,0,0,mlb
2018,Baltimore Orioles,47,115,0.29,28,53,19,62,0,0,0,0,0,0,0,0,mlb
2018,Boston Red Sox,108,54,0.667,57,24,51,30,0,0,1,0,1,0,1,0,mlb
2018,Chicago Cubs,95,68,0.583,51,31,44,37,0,1,0,0,0,0,0,0,mlb
2018,Chicago White Sox,62,100,0.383,30,51,32,49,0,0,0,0,0,0,0,0,mlb
2018,Cincinnati Reds,67,95,0.414,37,44,30,51,0,0,0,0,0,0,0,0,mlb
2018,Cleveland Indians,91,71,0.562,49,32,42,39,0,0,0,1,0,0,0,0,mlb
2018,Colorado Rockies,91,72,0.558,47,34,44,38,1,0,0,1,0,0,0,0,mlb
2018,Detroit Tigers,64,98,0.395,38,43,26,55,0,0,0,0,0,0,0,0,mlb
2018,Houston Astros,103,59,0.636,46,35,57,24,0,0,1,0,0,1,0,0,mlb
2018,Kansas City Royals,58,104,0.358,32,49,26,55,0,0,0,0,0,0,0,0,mlb
2018,Los Angeles Angels,80,82,0.494,42,39,38,43,0,0,0,0,0,0,0,0,mlb
2018,Los Angeles Dodgers,92,71,0.564,45,37,47,34,0,0,1,0,1,0,0,1,mlb
2018,Miami Marlins,63,98,0.391,38,43,25,55,0,0,0,0,0,0,0,0,mlb
2018,Miami Marlins,96,67,0.589,51,30,45,37,0,0,1,0,0,1,0,0,mlb
2018,Minnesota Twins,78,84,0.481,49,32,29,52,0,0,0,0,0,0,0,0,mlb
2018,New York Mets,77,85,0.475,37,44,40,41,0,0,0,0,0,0,0,0,mlb
2018,New York Yankees,100,62,0.617,53,28,47,34,1,0,0,1,0,0,0,0,mlb
2018,Oakland Athletics,97,65,0.599,50,31,47,34,0,1,0,0,0,0,0,0,mlb
2018,Philidelphia Phillies,80,82,0.494,49,32,31,50,0,0,0,0,0,0,0,0,mlb
2018,Pittsburgh Pirates,82,79,0.509,44,36,38,43,0,0,0,0,0,0,0,0,mlb
2018,San Dieglo Padres,66,96,0.407,31,50,35,46,0,0,0,0,0,0,0,0,mlb
2018,San Francisco Giants,73,89,0.451,42,39,31,50,0,0,0,0,0,0,0,0,mlb
2018,Seattle Mariners,89,73,0.549,45,36,44,37,0,0,0,0,0,0,0,0,mlb
2018,St. Louis Cardinals,88,74,0.543,43,38,45,36,0,0,0,0,0,0,0,0,mlb
2018,Tampa Bay Rays,90,72,0.556,51,30,39,42,0,0,0,0,0,0,0,0,mlb
2018,Texas Rangers,67,95,0.414,34,47,33,48,0,0,0,0,0,0,0,0,mlb
2018,Toronto Blue Jays,73,89,0.451,40,41,33,48,0,0,0,0,0,0,0,0,mlb
2018,Washington Nationals,82,80,0.506,41,40,41,40,0,0,0,0,0,0,0,0,mlb
2017,Arizona Diamondbacks,93,69,0.574,52,29,41,40,1,0,0,1,0,0,0,0,mlb
2017,Atlanta Braves,72,90,0.444,37,44,35,46,0,0,0,0,0,0,0,0,mlb
2017,Baltimore Orioles,75,87,0.463,46,35,29,52,0,0,0,0,0,0,0,0,mlb
2017,Boston Red Sox,93,69,0.574,48,33,45,36,0,0,0,1,0,0,0,0,mlb
2017,Chicago Cubs,92,70,0.568,48,33,44,37,0,0,1,0,0,1,0,0,mlb
2017,Chicago White Sox,67,95,0.414,39,42,28,53,0,0,0,0,0,0,0,0,mlb
2017,Cincinnati Reds,68,94,0.42,39,42,29,52,0,0,0,0,0,0,0,0,mlb
2017,Cleveland Indians,102,60,0.63,49,32,53,28,0,0,0,1,0,0,0,0,mlb
2017,Colorado Rockies,87,75,0.537,46,35,41,40,0,1,0,0,0,0,0,0,mlb
2017,Detroit Tigers,64,98,0.395,34,47,30,51,0,0,0,0,0,0,0,0,mlb
2017,Houston Astros,101,61,0.624,48,33,53,28,0,0,1,0,1,0,1,0,mlb
2017,Kansas City Royals,80,82,0.494,43,38,37,44,0,0,0,0,0,0,0,0,mlb
2017,Los Angeles Angels,80,82,0.494,43,38,37,44,0,0,0,0,0,0,0,0,mlb
2017,Los Angeles Dodgers,104,58,0.642,57,24,47,34,0,0,1,0,1,0,0,1,mlb
2017,Miami Marlins,77,85,0.475,42,36,35,49,0,0,0,0,0,0,0,0,mlb
2017,Miami Marlins,86,76,0.531,46,38,40,38,0,0,0,0,0,0,0,0,mlb
2017,Minnesota Twins,85,77,0.525,41,40,44,37,0,1,0,0,0,0,0,0,mlb
2017,New York Mets,70,92,0.432,37,44,33,48,0,0,0,0,0,0,0,0,mlb
2017,New York Yankees,91,71,0.562,51,30,40,41,1,0,1,0,0,1,0,0,mlb
2017,Oakland Athletics,75,87,0.463,46,35,29,52,0,0,0,0,0,0,0,0,mlb
2017,Philidelphia Phillies,66,96,0.407,39,42,27,54,0,0,0,0,0,0,0,0,mlb
2017,Pittsburgh Pirates,75,87,0.463,44,37,31,50,0,0,0,0,0,0,0,0,mlb
2017,San Dieglo Padres,71,91,0.438,43,38,28,53,0,0,0,0,0,0,0,0,mlb
2017,San Francisco Giants,64,98,0.395,38,43,26,55,0,0,0,0,0,0,0,0,mlb
2017,Seattle Mariners,78,84,0.481,40,41,38,43,0,0,0,0,0,0,0,0,mlb
2017,St. Louis Cardinals,83,79,0.512,44,37,39,42,0,0,0,0,0,0,0,0,mlb
2017,Tampa Bay Rays,80,82,0.494,42,39,38,43,0,0,0,0,0,0,0,0,mlb
2017,Texas Rangers,78,84,0.481,41,40,37,44,0,0,0,0,0,0,0,0,mlb
2017,Toronto Blue Jays,76,86,0.469,42,39,34,47,0,0,0,0,0,0,0,0,mlb
2017,Washington Nationals,97,65,0.599,47,34,50,31,0,0,0,1,0,0,0,0,mlb
2016,Arizona Diamondbacks,69,93,0.426,33,48,36,45,0,0,0,0,0,0,0,0,mlb
2016,Atlanta Braves,68,93,0.422,31,50,37,43,0,0,0,0,0,0,0,0,mlb
2016,Baltimore Orioles,89,73,0.549,50,31,39,42,0,1,0,0,0,0,0,0,mlb
2016,Boston Red Sox,93,69,0.574,47,34,46,35,0,0,0,1,0,0,0,0,mlb
2016,Chicago Cubs,103,58,0.64,57,24,46,34,0,0,1,0,1,0,1,0,mlb
2016,Chicago White Sox,78,84,0.481,45,36,33,48,0,0,0,0,0,0,0,0,mlb
2016,Cincinnati Reds,68,94,0.42,38,43,30,51,0,0,0,0,0,0,0,0,mlb
2016,Cleveland Indians,94,67,0.584,53,28,41,39,0,0,1,0,1,0,0,1,mlb
2016,Colorado Rockies,75,87,0.463,42,39,33,48,0,0,0,0,0,0,0,0,mlb
2016,Detroit Tigers,86,75,0.534,45,35,41,40,0,0,0,0,0,0,0,0,mlb
2016,Houston Astros,84,78,0.518,43,38,41,40,0,0,0,0,0,0,0,0,mlb
2016,Kansas City Royals,81,81,0.5,47,34,34,47,0,0,0,0,0,0,0,0,mlb
2016,Los Angeles Angels,74,88,0.457,40,41,34,47,0,0,0,0,0,0,0,0,mlb
2016,Los Angeles Dodgers,91,71,0.562,53,28,38,43,0,0,1,0,0,1,0,0,mlb
2016,Miami Marlins,79,82,0.491,40,40,39,42,0,0,0,0,0,0,0,0,mlb
2016,Miami Marlins,73,89,0.451,41,40,32,49,0,0,0,0,0,0,0,0,mlb
2016,Minnesota Twins,59,103,0.364,30,51,29,52,0,0,0,0,0,0,0,0,mlb
2016,New York Mets,87,75,0.537,44,37,43,38,0,1,0,0,0,0,0,0,mlb
2016,New York Yankees,84,78,0.518,48,33,36,45,0,0,0,0,0,0,0,0,mlb
2016,Oakland Athletics,69,93,0.426,34,47,35,46,0,0,0,0,0,0,0,0,mlb
2016,Philidelphia Phillies,71,91,0.438,37,44,34,47,0,0,0,0,0,0,0,0,mlb
2016,Pittsburgh Pirates,78,83,0.484,38,42,40,41,0,0,0,0,0,0,0,0,mlb
2016,San Dieglo Padres,68,94,0.42,39,42,29,52,0,0,0,0,0,0,0,0,mlb
2016,San Francisco Giants,87,75,0.537,45,36,42,39,1,0,0,1,0,0,0,0,mlb
2016,Seattle Mariners,86,76,0.531,44,37,42,39,0,0,0,0,0,0,0,0,mlb
2016,St. Louis Cardinals,86,76,0.531,38,43,48,33,0,0,0,0,0,0,0,0,mlb
2016,Tampa Bay Rays,68,94,0.42,36,45,32,49,0,0,0,0,0,0,0,0,mlb
2016,Texas Rangers,95,67,0.586,53,28,42,39,0,0,0,1,0,0,0,0,mlb
2016,Toronto Blue Jays,89,73,0.549,46,35,43,38,1,0,1,0,0,1,0,0,mlb
2016,Washington Nationals,95,67,0.586,50,31,45,36,0,0,0,1,0,0,0,0,mlb
2015,Arizona Diamondbacks,79,83,0.488,39,42,40,41,0,0,0,0,0,0,0,0,mlb
2015,Atlanta Braves,67,95,0.414,42,39,25,56,0,0,0,0,0,0,0,0,mlb
2015,Baltimore Orioles,81,81,0.5,47,31,34,50,0,0,0,0,0,0,0,0,mlb
2015,Boston Red Sox,78,84,0.481,43,38,35,46,0,0,0,0,0,0,0,0,mlb
2015,Chicago Cubs,97,65,0.599,49,32,48,33,1,0,1,0,0,1,0,0,mlb
2015,Chicago White Sox,76,86,0.469,40,41,36,45,0,0,0,0,0,0,0,0,mlb
2015,Cincinnati Reds,64,98,0.395,34,47,30,51,0,0,0,0,0,0,0,0,mlb
2015,Cleveland Indians,81,80,0.503,39,41,42,39,0,0,0,0,0,0,0,0,mlb
2015,Colorado Rockies,68,94,0.42,36,45,32,49,0,0,0,0,0,0,0,0,mlb
2015,Detroit Tigers,74,87,0.46,38,43,36,44,0,0,0,0,0,0,0,0,mlb
2015,Houston Astros,86,76,0.531,53,28,33,48,1,0,0,1,0,0,0,0,mlb
2015,Kansas City Royals,95,67,0.586,51,30,44,37,0,0,1,0,1,0,1,0,mlb
2015,Los Angeles Angels,85,77,0.525,49,32,36,45,0,0,0,0,0,0,0,0,mlb
2015,Los Angeles Dodgers,92,70,0.568,55,26,37,44,0,0,0,1,0,0,0,0,mlb
2015,Miami Marlins,71,91,0.438,41,40,30,51,0,0,0,0,0,0,0,0,mlb
2015,Miami Marlins,68,94,0.42,34,47,34,47,0,0,0,0,0,0,0,0,mlb
2015,Minnesota Twins,83,79,0.512,46,35,37,44,0,0,0,0,0,0,0,0,mlb
2015,New York Mets,90,72,0.556,49,32,41,40,0,0,1,0,1,0,0,1,mlb
2015,New York Yankees,87,75,0.537,45,36,42,39,0,1,0,0,0,0,0,0,mlb
2015,Oakland Athletics,68,94,0.42,34,47,34,47,0,0,0,0,0,0,0,0,mlb
2015,Philidelphia Phillies,63,99,0.389,37,44,26,55,0,0,0,0,0,0,0,0,mlb
2015,Pittsburgh Pirates,98,64,0.605,53,28,45,36,0,1,0,0,0,0,0,0,mlb
2015,San Dieglo Padres,74,88,0.457,39,42,35,46,0,0,0,0,0,0,0,0,mlb
2015,San Francisco Giants,84,78,0.518,47,34,37,44,0,0,0,0,0,0,0,0,mlb
2015,Seattle Mariners,76,86,0.469,36,45,40,41,0,0,0,0,0,0,0,0,mlb
2015,St. Louis Cardinals,100,62,0.617,55,26,45,36,0,0,0,1,0,0,0,0,mlb
2015,Tampa Bay Rays,80,82,0.494,42,42,38,40,0,0,0,0,0,0,0,0,mlb
2015,Texas Rangers,88,74,0.543,43,38,45,36,0,0,0,1,0,0,0,0,mlb
2015,Toronto Blue Jays,93,69,0.574,53,28,40,41,0,0,1,0,0,1,0,0,mlb
2015,Washington Nationals,83,79,0.512,46,35,37,44,0,0,0,0,0,0,0,0,mlb
2014,Arizona Diamondbacks,64,98,0.395,33,48,31,50,0,0,0,0,0,0,0,0,mlb
2014,Atlanta Braves,79,83,0.488,42,39,37,44,0,0,0,0,0,0,0,0,mlb
2014,Baltimore Orioles,96,66,0.593,50,31,46,35,0,0,1,0,0,1,0,0,mlb
2014,Boston Red Sox,71,91,0.438,34,47,37,44,0,0,0,0,0,0,0,0,mlb
2014,Chicago Cubs,73,89,0.451,41,40,32,49,0,0,0,0,0,0,0,0,mlb
2014,Chicago White Sox,73,89,0.451,40,41,33,48,0,0,0,0,0,0,0,0,mlb
2014,Cincinnati Reds,76,86,0.469,44,37,32,49,0,0,0,0,0,0,0,0,mlb
2014,Cleveland Indians,85,77,0.525,48,33,37,44,0,0,0,0,0,0,0,0,mlb
2014,Colorado Rockies,66,96,0.407,45,36,21,60,0,0,0,0,0,0,0,0,mlb
2014,Detroit Tigers,90,72,0.556,45,36,45,36,0,0,0,1,0,0,0,0,mlb
2014,Houston Astros,70,92,0.432,38,43,32,49,0,0,0,0,0,0,0,0,mlb
2014,Kansas City Royals,89,73,0.549,42,39,47,34,1,0,1,0,1,0,0,1,mlb
2014,Los Angeles Angels,98,64,0.605,52,29,46,35,0,0,0,1,0,0,0,0,mlb
2014,Los Angeles Dodgers,94,68,0.58,45,36,49,32,0,0,0,1,0,0,0,0,mlb
2014,Miami Marlins,77,85,0.475,42,39,35,46,0,0,0,0,0,0,0,0,mlb
2014,Miami Marlins,82,80,0.506,42,39,40,41,0,0,0,0,0,0,0,0,mlb
2014,Minnesota Twins,70,92,0.432,35,46,35,46,0,0,0,0,0,0,0,0,mlb
2014,New York Mets,79,83,0.488,40,41,39,42,0,0,0,0,0,0,0,0,mlb
2014,New York Yankees,84,78,0.518,43,38,41,40,0,0,0,0,0,0,0,0,mlb
2014,Oakland Athletics,88,74,0.543,48,33,40,41,0,1,0,0,0,0,0,0,mlb
2014,Philidelphia Phillies,73,89,0.451,37,44,36,45,0,0,0,0,0,0,0,0,mlb
2014,Pittsburgh Pirates,88,74,0.543,51,30,37,44,0,1,0,0,0,0,0,0,mlb
2014,San Dieglo Padres,77,85,0.475,48,33,29,52,0,0,0,0,0,0,0,0,mlb
2014,San Francisco Giants,88,74,0.543,45,36,43,38,1,0,1,0,1,0,1,0,mlb
2014,Seattle Mariners,87,75,0.537,41,40,46,35,0,0,0,0,0,0,0,0,mlb
2014,St. Louis Cardinals,90,72,0.556,51,30,39,42,0,0,1,0,0,1,0,0,mlb
2014,Tampa Bay Rays,77,85,0.475,36,45,41,40,0,0,0,0,0,0,0,0,mlb
2014,Texas Rangers,67,95,0.414,33,48,34,47,0,0,0,0,0,0,0,0,mlb
2014,Toronto Blue Jays,83,79,0.512,46,35,37,44,0,0,0,0,0,0,0,0,mlb
2014,Washington Nationals,96,66,0.593,51,30,45,36,0,0,0,1,0,0,0,0,mlb
2013,Arizona Diamondbacks,81,81,0.5,45,36,36,45,0,0,0,0,0,0,0,0,mlb
2013,Atlanta Braves,96,66,0.593,56,25,40,41,0,0,0,1,0,0,0,0,mlb
2013,Baltimore Orioles,85,77,0.525,46,35,39,42,0,0,0,0,0,0,0,0,mlb
2013,Boston Red Sox,97,65,0.599,53,28,44,37,0,0,1,0,1,0,1,0,mlb
2013,Chicago Cubs,66,96,0.407,31,50,35,46,0,0,0,0,0,0,0,0,mlb
2013,Chicago White Sox,63,99,0.389,37,44,26,55,0,0,0,0,0,0,0,0,mlb
2013,Cincinnati Reds,90,72,0.556,49,31,41,41,0,1,0,0,0,0,0,0,mlb
2013,Cleveland Indians,92,70,0.568,51,30,41,40,0,1,0,0,0,0,0,0,mlb
2013,Colorado Rockies,74,88,0.457,45,36,29,52,0,0,0,0,0,0,0,0,mlb
2013,Detroit Tigers,93,69,0.574,51,30,42,39,0,0,1,0,0,1,0,0,mlb
2013,Houston Astros,51,111,0.315,24,57,27,54,0,0,0,0,0,0,0,0,mlb
2013,Kansas City Royals,86,76,0.531,44,37,42,39,0,0,0,0,0,0,0,0,mlb
2013,Los Angeles Angels,78,84,0.481,39,42,39,42,0,0,0,0,0,0,0,0,mlb
2013,Los Angeles Dodgers,92,70,0.568,47,34,45,36,0,0,1,0,0,1,0,0,mlb
2013,Miami Marlins,62,100,0.383,36,45,26,55,0,0,0,0,0,0,0,0,mlb
2013,Miami Marlins,74,88,0.457,37,44,37,44,0,0,0,0,0,0,0,0,mlb
2013,Minnesota Twins,66,96,0.407,32,49,34,47,0,0,0,0,0,0,0,0,mlb
2013,New York Mets,74,88,0.457,33,48,41,40,0,0,0,0,0,0,0,0,mlb
2013,New York Yankees,85,77,0.525,46,35,39,42,0,0,0,0,0,0,0,0,mlb
2013,Oakland Athletics,96,66,0.593,52,29,44,37,0,0,0,1,0,0,0,0,mlb
2013,Philidelphia Phillies,73,89,0.451,43,38,30,51,0,0,0,0,0,0,0,0,mlb
2013,Pittsburgh Pirates,94,68,0.58,50,31,44,37,1,0,0,1,0,0,0,0,mlb
2013,San Dieglo Padres,76,86,0.469,45,36,31,50,0,0,0,0,0,0,0,0,mlb
2013,San Francisco Giants,76,86,0.469,42,40,34,46,0,0,0,0,0,0,0,0,mlb
2013,Seattle Mariners,71,91,0.438,36,45,35,46,0,0,0,0,0,0,0,0,mlb
2013,St. Louis Cardinals,97,65,0.599,54,27,43,38,0,0,1,0,1,0,0,1,mlb
2013,Tampa Bay Rays,92,71,0.564,51,30,41,41,1,0,0,1,0,0,0,0,mlb
2013,Texas Rangers,91,72,0.558,46,36,45,36,0,0,0,0,0,0,0,0,mlb
2013,Toronto Blue Jays,74,88,0.457,40,41,34,47,0,0,0,0,0,0,0,0,mlb
2013,Washington Nationals,86,76,0.531,47,34,39,42,0,0,0,0,0,0,0,0,mlb
2012,Arizona Diamondbacks,81,81,0.5,41,40,40,41,0,0,0,0,0,0,0,0,mlb
2012,Atlanta Braves,94,68,0.58,48,33,46,35,0,1,0,0,0,0,0,0,mlb
2012,Baltimore Orioles,93,69,0.574,47,34,46,35,1,0,0,1,0,0,0,0,mlb
2012,Boston Red Sox,69,93,0.426,34,47,35,46,0,0,0,0,0,0,0,0,mlb
2012,Chicago Cubs,61,101,0.377,38,43,23,58,0,0,0,0,0,0,0,0,mlb
2012,Chicago White Sox,85,77,0.525,45,36,40,41,0,0,0,0,0,0,0,0,mlb
2012,Cincinnati Reds,97,65,0.599,50,31,47,34,0,0,0,1,0,0,0,0,mlb
2012,Cleveland Indians,68,94,0.42,37,44,31,50,0,0,0,0,0,0,0,0,mlb
2012,Colorado Rockies,64,98,0.395,35,46,29,52,0,0,0,0,0,0,0,0,mlb
2012,Detroit Tigers,88,74,0.543,50,31,38,43,0,0,1,0,1,0,0,1,mlb
2012,Houston Astros,55,107,0.34,35,46,20,61,0,0,0,0,0,0,0,0,mlb
2012,Kansas City Royals,72,90,0.444,37,44,35,46,0,0,0,0,0,0,0,0,mlb
2012,Los Angeles Angels,89,73,0.549,46,35,43,38,0,0,0,0,0,0,0,0,mlb
2012,Los Angeles Dodgers,86,76,0.531,45,36,41,40,0,0,0,0,0,0,0,0,mlb
2012,Miami Marlins,69,93,0.426,38,43,31,50,0,0,0,0,0,0,0,0,mlb
2012,Miami Marlins,83,79,0.512,49,32,34,47,0,0,0,0,0,0,0,0,mlb
2012,Minnesota Twins,66,96,0.407,31,50,35,46,0,0,0,0,0,0,0,0,mlb
2012,New York Mets,74,88,0.457,36,45,38,43,0,0,0,0,0,0,0,0,mlb
2012,New York Yankees,95,67,0.586,51,30,44,37,0,0,1,0,0,1,0,0,mlb
2012,Oakland Athletics,94,68,0.58,50,31,44,37,0,0,0,1,0,0,0,0,mlb
2012,Philidelphia Phillies,81,81,0.5,40,41,41,40,0,0,0,0,0,0,0,0,mlb
2012,Pittsburgh Pirates,79,83,0.488,45,36,34,47,0,0,0,0,0,0,0,0,mlb
2012,San Dieglo Padres,76,86,0.469,42,39,34,47,0,0,0,0,0,0,0,0,mlb
2012,San Francisco Giants,94,68,0.58,48,33,46,35,0,0,1,0,1,0,1,0,mlb
2012,Seattle Mariners,75,87,0.463,40,41,35,46,0,0,0,0,0,0,0,0,mlb
2012,St. Louis Cardinals,88,74,0.543,50,31,38,43,1,0,1,0,0,1,0,0,mlb
2012,Tampa Bay Rays,90,72,0.556,46,35,44,37,0,0,0,0,0,0,0,0,mlb
2012,Texas Rangers,93,69,0.574,50,31,43,38,0,1,0,0,0,0,0,0,mlb
2012,Toronto Blue Jays,73,89,0.451,41,40,32,49,0,0,0,0,0,0,0,0,mlb
2012,Washington Nationals,98,64,0.605,50,31,48,33,0,0,0,1,0,0,0,0,mlb
2011,Arizona Diamondbacks,94,68,0.58,51,30,43,38,0,0,0,1,0,0,0,0,mlb
2011,Atlanta Braves,89,73,0.549,47,34,42,39,0,0,0,0,0,0,0,0,mlb
2011,Baltimore Orioles,69,93,0.426,39,42,30,51,0,0,0,0,0,0,0,0,mlb
2011,Boston Red Sox,90,72,0.556,45,36,45,36,0,0,0,0,0,0,0,0,mlb
2011,Chicago Cubs,71,91,0.438,39,42,32,49,0,0,0,0,0,0,0,0,mlb
2011,Chicago White Sox,79,83,0.488,36,45,43,38,0,0,0,0,0,0,0,0,mlb
2011,Cincinnati Reds,79,83,0.488,42,39,37,44,0,0,0,0,0,0,0,0,mlb
2011,Cleveland Indians,80,82,0.494,44,37,36,45,0,0,0,0,0,0,0,0,mlb
2011,Colorado Rockies,73,89,0.451,38,43,35,46,0,0,0,0,0,0,0,0,mlb
2011,Detroit Tigers,95,67,0.586,50,31,45,36,0,0,1,0,0,1,0,0,mlb
2011,Florida Marlins,72,90,0.444,31,47,41,43,0,0,0,0,0,0,0,0,mlb
2011,Houston Astros,56,106,0.346,31,50,25,56,0,0,0,0,0,0,0,0,mlb
2011,Kansas City Royals,71,91,0.438,40,41,31,50,0,0,0,0,0,0,0,0,mlb
2011,Los Angeles Angels,86,76,0.531,45,36,41,40,0,0,0,0,0,0,0,0,mlb
2011,Los Angeles Dodgers,82,79,0.509,42,39,40,40,0,0,0,0,0,0,0,0,mlb
2011,Miami Marlins,96,66,0.593,57,24,39,42,0,0,0,0,0,1,0,0,mlb
2011,Minnesota Twins,63,99,0.389,33,48,30,51,0,0,1,0,0,0,0,0,mlb
2011,New York Mets,77,85,0.475,34,47,43,38,0,0,0,0,0,0,0,0,mlb
2011,New York Yankees,97,65,0.599,52,29,45,36,0,0,0,1,0,0,0,0,mlb
2011,Oakland Athletics,74,88,0.457,43,38,31,50,0,0,0,0,0,0,0,0,mlb
2011,Philidelphia Phillies,102,60,0.63,52,29,50,31,0,0,0,1,0,0,0,0,mlb
2011,Pittsburgh Pirates,72,90,0.444,36,45,36,45,0,0,0,0,0,0,0,0,mlb
2011,San Dieglo Padres,71,91,0.438,35,46,36,45,0,0,0,0,0,0,0,0,mlb
2011,San Francisco Giants,86,76,0.531,46,35,40,41,0,0,0,0,0,0,0,0,mlb
2011,Seattle Mariners,67,95,0.414,39,45,28,50,0,0,0,0,0,0,0,0,mlb
2011,St. Louis Cardinals,90,72,0.556,45,36,45,36,0,0,1,0,1,0,1,0,mlb
2011,Tampa Bay Rays,91,71,0.562,47,34,44,37,0,0,0,1,0,0,0,0,mlb
2011,Texas Rangers,96,66,0.593,52,29,44,37,0,0,1,0,1,0,0,1,mlb
2011,Toronto Blue Jays,81,81,0.5,42,39,39,42,0,0,0,0,0,0,0,0,mlb
2011,Washington Nationals,80,81,0.497,44,36,36,45,0,0,0,0,0,0,0,0,mlb
2010,Arizona Diamondbacks,65,97,0.401,40,41,25,56,0,0,0,0,0,0,0,0,mlb
2010,Atlanta Braves,91,71,0.562,56,25,35,46,0,0,0,1,0,0,0,0,mlb
2010,Baltimore Orioles,66,96,0.407,37,44,29,52,0,0,0,0,0,0,0,0,mlb
2010,Boston Red Sox,89,73,0.549,46,35,43,38,0,0,0,0,0,0,0,0,mlb
2010,Chicago Cubs,75,87,0.463,35,46,40,41,0,0,0,0,0,0,0,0,mlb
2010,Chicago White Sox,88,74,0.543,45,36,43,38,0,0,0,0,0,0,0,0,mlb
2010,Cincinnati Reds,91,71,0.562,49,32,42,39,0,0,0,1,0,0,0,0,mlb
2010,Cleveland Indians,69,93,0.426,38,43,31,50,0,0,0,0,0,0,0,0,mlb
2010,Colorado Rockies,83,79,0.512,52,29,31,50,0,0,0,0,0,0,0,0,mlb
2010,Detroit Tigers,81,81,0.5,52,29,29,52,0,0,0,0,0,0,0,0,mlb
2010,Florida Marlins,80,82,0.494,41,40,39,42,0,0,0,0,0,0,0,0,mlb
2010,Houston Astros,76,86,0.469,42,39,34,47,0,0,0,0,0,0,0,0,mlb
2010,Kansas City Royals,67,95,0.414,38,43,29,52,0,0,0,0,0,0,0,0,mlb
2010,Los Angeles Angels,80,82,0.494,43,38,37,44,0,0,0,0,0,0,0,0,mlb
2010,Los Angeles Dodgers,80,82,0.494,45,36,35,46,0,0,0,0,0,0,0,0,mlb
2010,Miami Marlins,77,85,0.475,40,41,37,44,0,0,0,0,0,0,0,0,mlb
2010,Minnesota Twins,94,68,0.58,53,28,41,40,0,0,0,1,0,0,0,0,mlb
2010,New York Mets,79,83,0.488,47,34,32,49,0,0,0,0,0,0,0,0,mlb
2010,New York Yankees,95,67,0.586,52,29,43,38,0,0,1,0,0,1,0,0,mlb
2010,Oakland Athletics,81,81,0.5,47,34,34,47,0,0,0,0,0,0,0,0,mlb
2010,Philidelphia Phillies,97,65,0.599,54,30,43,35,0,0,1,0,0,1,0,0,mlb
2010,Pittsburgh Pirates,57,105,0.352,40,41,17,64,0,0,0,0,0,0,0,0,mlb
2010,San Dieglo Padres,90,72,0.556,45,36,45,36,0,0,0,0,0,0,0,0,mlb
2010,San Francisco Giants,92,70,0.568,49,32,43,38,0,0,1,0,1,0,1,0,mlb
2010,Seattle Mariners,61,101,0.377,35,46,26,55,0,0,0,0,0,0,0,0,mlb
2010,St. Louis Cardinals,86,76,0.531,52,29,34,47,0,0,0,0,0,0,0,0,mlb
2010,Tampa Bay Rays,96,66,0.593,49,32,47,34,0,0,0,1,0,0,0,0,mlb
2010,Texas Rangers,90,72,0.556,51,30,39,42,0,0,1,0,1,0,0,1,mlb
2010,Toronto Blue Jays,85,77,0.525,45,33,40,44,0,0,0,0,0,0,0,0,mlb
2010,Washington Nationals,69,93,0.426,41,40,28,53,0,0,0,0,0,0,0,0,mlb
2009,Arizona Diamondbacks,70,92,0.432,36,45,34,47,0,0,0,0,0,0,0,0,mlb
2009,Atlanta Braves,86,76,0.531,40,41,46,35,0,0,0,0,0,0,0,0,mlb
2009,Baltimore Orioles,64,98,0.395,39,42,25,56,0,0,0,0,0,0,0,0,mlb
2009,Boston Red Sox,95,67,0.586,56,25,39,42,0,0,0,1,0,0,0,0,mlb
2009,Chicago Cubs,83,78,0.515,46,34,37,44,0,0,0,0,0,0,0,0,mlb
2009,Chicago White Sox,79,83,0.488,43,38,36,45,0,0,0,0,0,0,0,0,mlb
2009,Cincinnati Reds,78,84,0.481,40,41,38,43,0,0,0,0,0,0,0,0,mlb
2009,Cleveland Indians,65,97,0.401,35,46,30,51,0,0,0,0,0,0,0,0,mlb
2009,Colorado Rockies,92,70,0.568,51,30,41,40,0,0,0,1,0,0,0,0,mlb
2009,Detroit Tigers,86,77,0.528,51,30,35,47,0,0,0,0,0,0,0,0,mlb
2009,Florida Marlins,87,75,0.537,43,38,44,37,0,0,0,0,0,0,0,0,mlb
2009,Houston Astros,74,88,0.457,44,37,30,51,0,0,0,0,0,0,0,0,mlb
2009,Kansas City Royals,65,97,0.401,33,48,32,49,0,0,0,0,0,0,0,0,mlb
2009,Los Angeles Angels,97,65,0.599,49,32,48,33,0,0,1,0,0,1,0,0,mlb
2009,Los Angeles Dodgers,95,67,0.586,50,31,45,36,0,0,1,0,0,1,0,0,mlb
2009,Miami Marlins,80,82,0.494,40,41,40,41,0,0,0,0,0,0,0,0,mlb
2009,Minnesota Twins,87,76,0.534,49,33,38,43,0,0,0,1,0,0,0,0,mlb
2009,New York Mets,70,92,0.432,41,40,29,52,0,0,0,0,0,0,0,0,mlb
2009,New York Yankees,103,59,0.636,57,24,46,35,0,0,1,0,1,0,1,0,mlb
2009,Oakland Athletics,75,87,0.463,40,41,35,46,0,0,0,0,0,0,0,0,mlb
2009,Philidelphia Phillies,93,69,0.574,45,36,48,33,0,0,1,0,1,0,0,0,mlb
2009,Pittsburgh Pirates,62,99,0.385,40,41,22,58,0,0,0,0,0,0,0,1,mlb
2009,San Dieglo Padres,75,87,0.463,42,39,33,48,0,0,0,0,0,0,0,0,mlb
2009,San Francisco Giants,88,74,0.543,52,29,36,45,0,0,0,0,0,0,0,0,mlb
2009,Seattle Mariners,85,77,0.525,48,33,37,44,0,0,0,0,0,0,0,0,mlb
2009,St. Louis Cardinals,91,71,0.562,46,35,45,36,0,0,0,1,0,0,0,0,mlb
2009,Tampa Bay Rays,84,78,0.518,52,29,32,49,0,0,0,0,0,0,0,0,mlb
2009,Texas Rangers,87,75,0.537,48,33,39,42,0,0,0,0,0,0,0,0,mlb
2009,Toronto Blue Jays,75,87,0.463,44,37,31,50,0,0,0,0,0,0,0,0,mlb
2009,Washington Nationals,59,103,0.364,33,48,26,55,0,0,0,0,0,0,0,0,mlb
2008,Arizona Diamondbacks,82,80,0.506,48,33,34,47,0,0,0,0,0,0,0,0,mlb
2008,Atlanta Braves,72,90,0.444,43,38,29,52,0,0,0,0,0,0,0,0,mlb
2008,Baltimore Orioles,68,93,0.422,37,43,31,50,0,0,0,0,0,0,0,0,mlb
2008,Boston Red Sox,95,67,0.586,56,25,39,42,0,0,1,0,0,1,0,0,mlb
2008,Chicago Cubs,97,64,0.603,55,26,42,38,0,0,0,1,0,0,0,0,mlb
2008,Chicago White Sox,89,74,0.546,54,28,35,46,0,0,0,1,0,0,0,0,mlb
2008,Cincinnati Reds,74,88,0.457,43,38,31,50,0,0,0,0,0,0,0,0,mlb
2008,Cleveland Indians,81,81,0.5,45,36,36,45,0,0,0,0,0,0,0,0,mlb
2008,Colorado Rockies,74,88,0.457,43,38,31,50,0,0,0,0,0,0,0,0,mlb
2008,Detroit Tigers,74,88,0.457,40,41,34,47,0,0,0,0,0,0,0,0,mlb
2008,Florida Marlins,84,77,0.522,45,36,39,41,0,0,0,0,0,0,0,0,mlb
2008,Houston Astros,86,75,0.534,47,33,39,42,0,0,0,0,0,0,0,0,mlb
2008,Kansas City Royals,75,87,0.463,38,43,37,44,0,0,0,0,0,0,0,0,mlb
2008,Los Angeles Angels,100,62,0.617,50,31,50,31,0,0,0,1,0,0,0,0,mlb
2008,Los Angeles Dodgers,84,78,0.518,48,33,36,45,0,0,1,0,0,1,0,0,mlb
2008,Miami Marlins,90,72,0.556,49,32,41,40,0,0,0,1,0,0,0,0,mlb
2008,Minnesota Twins,88,75,0.54,53,28,35,47,0,0,0,0,0,0,0,0,mlb
2008,New York Mets,89,73,0.549,48,33,41,40,0,0,0,0,0,0,0,0,mlb
2008,New York Yankees,89,73,0.549,48,33,41,40,0,0,0,0,0,0,0,0,mlb
2008,Oakland Athletics,75,86,0.466,43,38,32,48,0,0,0,0,0,0,0,0,mlb
2008,Philidelphia Phillies,92,70,0.568,48,33,44,37,0,0,1,0,1,0,1,0,mlb
2008,Pittsburgh Pirates,67,95,0.414,39,42,28,53,0,0,0,0,0,0,0,0,mlb
2008,San Dieglo Padres,63,99,0.389,35,46,28,53,0,0,0,0,0,0,0,0,mlb
2008,San Francisco Giants,72,90,0.444,37,44,35,46,0,0,0,0,0,0,0,0,mlb
2008,Seattle Mariners,61,101,0.377,35,46,26,55,0,0,0,0,0,0,0,0,mlb
2008,St. Louis Cardinals,86,76,0.531,46,35,40,41,0,0,0,0,0,0,0,0,mlb
2008,Tampa Bay Rays,97,65,0.599,57,24,40,41,0,0,1,0,1,0,0,1,mlb
2008,Texas Rangers,79,83,0.488,40,41,39,42,0,0,0,0,0,0,0,0,mlb
2008,Toronto Blue Jays,86,76,0.531,47,34,39,42,0,0,0,0,0,0,0,0,mlb
2008,Washington Nationals,59,102,0.366,34,46,25,56,0,0,0,0,0,0,0,0,mlb
2007,Arizona Diamondbacks,90,72,0.556,50,31,40,41,0,0,1,0,0,1,0,0,mlb
2007,Atlanta Braves,84,78,0.518,44,37,40,41,0,0,0,0,0,0,0,0,mlb
2007,Baltimore Orioles,69,93,0.426,35,46,34,47,0,0,0,0,0,0,0,0,mlb
2007,Boston Red Sox,96,66,0.593,51,30,45,36,0,0,1,0,1,0,1,0,mlb
2007,Chicago Cubs,85,77,0.525,44,37,41,40,0,0,0,1,0,0,0,0,mlb
2007,Chicago White Sox,72,90,0.444,38,43,34,47,0,0,0,0,0,0,0,0,mlb
2007,Cincinnati Reds,72,90,0.444,39,42,33,48,0,0,0,0,0,0,0,0,mlb
2007,Cleveland Indians,96,66,0.593,51,29,45,37,0,0,1,0,0,1,0,0,mlb
2007,Colorado Rockies,90,73,0.552,51,31,39,42,0,0,1,0,1,0,0,1,mlb
2007,Detroit Tigers,88,74,0.543,45,36,43,38,0,0,0,0,0,0,0,0,mlb
2007,Florida Marlins,71,91,0.438,36,45,35,46,0,0,0,0,0,0,0,0,mlb
2007,Houston Astros,73,89,0.451,42,39,31,50,0,0,0,0,0,0,0,0,mlb
2007,Kansas City Royals,69,93,0.426,35,46,34,47,0,0,0,0,0,0,0,0,mlb
2007,Los Angeles Angels,94,68,0.58,54,27,40,41,0,0,0,1,0,0,0,0,mlb
2007,Los Angeles Dodgers,82,80,0.506,43,38,39,42,0,0,0,0,0,0,0,0,mlb
2007,Miami Marlins,83,79,0.512,51,30,32,49,0,0,0,0,0,0,0,0,mlb
2007,Minnesota Twins,79,83,0.488,41,40,38,43,0,0,0,0,0,0,0,0,mlb
2007,New York Mets,88,74,0.543,41,40,47,34,0,0,0,0,0,0,0,0,mlb
2007,New York Yankees,94,68,0.58,52,29,42,39,0,0,0,1,0,0,0,0,mlb
2007,Oakland Athletics,76,86,0.469,40,41,36,45,0,0,0,0,0,0,0,0,mlb
2007,Philidelphia Phillies,89,73,0.549,47,34,42,39,0,0,0,1,0,0,0,0,mlb
2007,Pittsburgh Pirates,68,94,0.42,37,44,31,50,0,0,0,0,0,0,0,0,mlb
2007,San Dieglo Padres,89,74,0.546,47,34,42,40,0,0,0,0,0,0,0,0,mlb
2007,San Francisco Giants,71,91,0.438,39,42,32,49,0,0,0,0,0,0,0,0,mlb
2007,Seattle Mariners,88,74,0.543,49,33,39,41,0,0,0,0,0,0,0,0,mlb
2007,St. Louis Cardinals,78,84,0.481,43,38,35,46,0,0,0,0,0,0,0,0,mlb
2007,Tampa Bay Devil Rays,66,96,0.407,37,44,29,52,0,0,0,0,0,0,0,0,mlb
2007,Texas Rangers,75,87,0.463,47,34,28,53,0,0,0,0,0,0,0,0,mlb
2007,Toronto Blue Jays,83,79,0.512,49,32,34,47,0,0,0,0,0,0,0,0,mlb
2007,Washington Nationals,73,89,0.451,40,41,33,48,0,0,0,0,0,0,0,0,mlb
2006,Arizona Diamondbacks,76,86,0.469,39,42,37,44,0,0,0,0,0,0,0,0,mlb
2006,Atlanta Braves,79,83,0.488,40,41,39,42,0,0,0,0,0,0,0,0,mlb
2006,Baltimore Orioles,70,92,0.432,40,41,30,51,0,0,0,0,0,0,0,0,mlb
2006,Boston Red Sox,86,76,0.531,48,33,38,43,0,0,0,0,0,0,0,0,mlb
2006,Chicago Cubs,66,96,0.407,36,45,30,51,0,0,0,0,0,0,0,0,mlb
2006,Chicago White Sox,90,72,0.556,49,32,41,40,0,0,0,0,0,0,0,0,mlb
2006,Cincinnati Reds,80,82,0.494,42,39,38,43,0,0,0,0,0,0,0,0,mlb
2006,Cleveland Indians,78,84,0.481,44,37,34,47,0,0,0,0,0,0,0,0,mlb
2006,Colorado Rockies,76,86,0.469,44,37,32,49,0,0,0,0,0,0,0,0,mlb
2006,Detroit Tigers,95,67,0.586,46,35,49,32,0,0,1,0,1,0,0,1,mlb
2006,Florida Marlins,78,84,0.481,42,39,36,45,0,0,0,0,0,0,0,0,mlb
2006,Houston Astros,82,80,0.506,44,37,38,43,0,0,0,0,0,0,0,0,mlb
2006,Kansas City Royals,62,100,0.383,34,47,28,53,0,0,0,0,0,0,0,0,mlb
2006,Los Angeles Angels,89,73,0.549,45,36,44,37,0,0,0,0,0,0,0,0,mlb
2006,Los Angeles Dodgers,88,74,0.543,49,32,39,42,0,0,0,1,0,0,0,0,mlb
2006,Miami Marlins,75,87,0.463,48,33,27,54,0,0,0,0,0,0,0,0,mlb
2006,Minnesota Twins,96,66,0.593,54,27,42,39,0,0,0,1,0,0,0,0,mlb
2006,New York Mets,97,65,0.599,50,31,47,34,0,0,1,0,0,1,0,0,mlb
2006,New York Yankees,97,65,0.599,50,31,47,34,0,0,0,1,0,0,0,0,mlb
2006,Oakland Athletics,93,69,0.574,49,32,44,37,0,0,1,0,0,1,0,0,mlb
2006,Philidelphia Phillies,85,77,0.525,41,40,44,37,0,0,0,0,0,0,0,0,mlb
2006,Pittsburgh Pirates,67,95,0.414,43,38,24,57,0,0,0,0,0,0,0,0,mlb
2006,San Dieglo Padres,88,74,0.543,43,38,45,36,0,0,0,1,0,0,0,0,mlb
2006,San Francisco Giants,76,85,0.472,43,38,33,47,0,0,0,0,0,0,0,0,mlb
2006,Seattle Mariners,78,84,0.481,44,37,34,47,0,0,0,0,0,0,0,0,mlb
2006,St. Louis Cardinals,83,78,0.515,49,31,34,47,0,0,1,0,1,0,1,0,mlb
2006,Tampa Bay Devil Rays,61,101,0.377,41,40,20,61,0,0,0,0,0,0,0,0,mlb
2006,Texas Rangers,80,82,0.494,39,42,41,40,0,0,0,0,0,0,0,0,mlb
2006,Toronto Blue Jays,87,75,0.537,50,31,37,44,0,0,0,0,0,0,0,0,mlb
2006,Washington Nationals,71,91,0.438,41,40,30,51,0,0,0,0,0,0,0,0,mlb
2005,Arizona Diamondbacks,77,85,0.475,36,45,41,40,0,0,0,0,0,0,0,0,mlb
2005,Atlanta Braves,90,72,0.556,53,28,37,44,0,0,0,1,0,0,0,0,mlb
2005,Baltimore Orioles,74,88,0.457,36,45,38,43,0,0,0,0,0,0,0,0,mlb
2005,Boston Red Sox,95,67,0.586,54,27,41,40,0,0,0,1,0,0,0,0,mlb
2005,Chicago Cubs,79,83,0.488,38,43,41,40,0,0,0,0,0,0,0,0,mlb
2005,Chicago White Sox,99,63,0.611,47,34,52,29,0,0,1,0,1,0,1,0,mlb
2005,Cincinnati Reds,73,89,0.451,42,39,31,50,0,0,0,0,0,0,0,0,mlb
2005,Cleveland Indians,93,69,0.574,43,38,50,31,0,0,0,0,0,0,0,0,mlb
2005,Colorado Rockies,67,95,0.414,40,41,27,54,0,0,0,0,0,0,0,0,mlb
2005,Detroit Tigers,71,91,0.438,39,42,32,49,0,0,0,0,0,0,0,0,mlb
2005,Florida Marlins,83,79,0.512,45,36,38,43,0,0,0,0,0,0,0,0,mlb
2005,Houston Astros,89,73,0.549,53,28,36,45,0,0,1,0,1,0,0,1,mlb
2005,Kansas City Royals,56,106,0.346,34,47,22,59,0,0,0,0,0,0,0,0,mlb
2005,Los Angeles Angels,95,67,0.586,49,32,46,35,0,0,1,0,0,1,0,0,mlb
2005,Los Angeles Dodgers,71,91,0.438,40,41,31,50,0,0,0,0,0,0,0,0,mlb
2005,Miami Marlins,81,81,0.5,46,35,35,46,0,0,0,0,0,0,0,0,mlb
2005,Minnesota Twins,83,79,0.512,45,36,38,43,0,0,0,0,0,0,0,0,mlb
2005,New York Mets,83,79,0.512,48,33,35,46,0,0,0,0,0,0,0,0,mlb
2005,New York Yankees,95,67,0.586,53,28,42,39,0,0,0,1,0,0,0,0,mlb
2005,Oakland Athletics,88,74,0.543,45,36,43,38,0,0,0,0,0,0,0,0,mlb
2005,Philidelphia Phillies,88,74,0.543,46,35,42,39,0,0,0,0,0,0,0,0,mlb
2005,Pittsburgh Pirates,67,95,0.414,34,47,33,48,0,0,0,0,0,0,0,0,mlb
2005,San Dieglo Padres,82,80,0.506,46,35,36,45,0,0,0,1,0,0,0,0,mlb
2005,San Francisco Giants,75,87,0.463,37,44,38,43,0,0,0,0,0,0,0,0,mlb
2005,Seattle Mariners,69,93,0.426,39,42,30,51,0,0,0,0,0,0,0,0,mlb
2005,St. Louis Cardinals,100,62,0.617,50,31,50,31,0,0,1,0,0,1,0,0,mlb
2005,Tampa Bay Devil Rays,67,95,0.414,40,41,27,54,0,0,0,0,0,0,0,0,mlb
2005,Texas Rangers,79,83,0.488,44,37,35,46,0,0,0,0,0,0,0,0,mlb
2005,Toronto Blue Jays,80,82,0.494,43,38,37,44,0,0,0,0,0,0,0,0,mlb
2005,Washington Nationals,81,81,0.5,41,40,40,41,0,0,0,0,0,0,0,0,mlb
2004,Anaheim Angels,92,70,0.568,45,36,47,34,0,0,0,1,0,0,0,0,mlb
2004,Arizona Diamondbacks,51,111,0.315,29,52,22,59,0,0,0,0,0,0,0,0,mlb
2004,Atlanta Braves,96,66,0.593,49,32,47,34,0,0,0,1,0,0,0,0,mlb
2004,Baltimore Orioles,78,84,0.481,38,43,40,41,0,0,0,0,0,0,0,0,mlb
2004,Boston Red Sox,98,64,0.605,55,26,43,38,0,0,1,0,1,0,1,0,mlb
2004,Chicago Cubs,89,73,0.549,45,37,44,36,0,0,0,0,0,0,0,0,mlb
2004,Chicago White Sox,83,79,0.512,46,35,37,44,0,0,0,0,0,0,0,0,mlb
2004,Cincinnati Reds,76,86,0.469,40,41,36,45,0,0,0,0,0,0,0,0,mlb
2004,Cleveland Indians,80,82,0.494,44,37,36,45,0,0,0,0,0,0,0,0,mlb
2004,Colorado Rockies,68,94,0.42,38,43,30,51,0,0,0,0,0,0,0,0,mlb
2004,Detroit Tigers,72,90,0.444,38,43,34,47,0,0,0,0,0,0,0,0,mlb
2004,Florida Marlins,83,79,0.512,42,38,41,41,0,0,0,0,0,0,0,0,mlb
2004,Houston Astros,92,70,0.568,48,33,44,37,0,0,1,0,0,1,0,0,mlb
2004,Kansas City Royals,58,104,0.358,33,47,25,57,0,0,0,0,0,0,0,0,mlb
2004,Los Angeles Dodgers,93,69,0.574,49,32,44,37,0,0,0,1,0,0,0,0,mlb
2004,Miami Marlins,67,94,0.416,36,45,31,49,0,0,0,0,0,0,0,0,mlb
2004,Minnesota Twins,92,70,0.568,49,32,43,38,0,0,0,1,0,0,0,0,mlb
2004,Montreal Expos,67,95,0.414,35,45,32,50,0,0,0,0,0,0,0,0,mlb
2004,New York Mets,71,91,0.438,38,43,33,48,0,0,0,0,0,0,0,0,mlb
2004,New York Yankees,101,61,0.624,57,24,44,37,0,0,1,0,0,1,0,0,mlb
2004,Oakland Athletics,91,71,0.562,52,29,39,42,0,0,0,0,0,0,0,0,mlb
2004,Philidelphia Phillies,86,76,0.531,42,39,44,37,0,0,0,0,0,0,0,0,mlb
2004,Pittsburgh Pirates,72,89,0.447,39,41,33,48,0,0,0,0,0,0,0,0,mlb
2004,San Dieglo Padres,87,75,0.537,42,39,45,36,0,0,0,0,0,0,0,0,mlb
2004,San Francisco Giants,91,71,0.562,47,35,44,36,0,0,0,0,0,0,0,0,mlb
2004,Seattle Mariners,63,99,0.389,38,44,25,55,0,0,0,0,0,0,0,0,mlb
2004,St. Louis Cardinals,105,57,0.648,53,28,52,29,0,0,1,0,1,0,0,1,mlb
2004,Tampa Bay Devil Rays,70,91,0.435,41,39,29,52,0,0,0,0,0,0,0,0,mlb
2004,Texas Rangers,89,73,0.549,51,30,38,43,0,0,0,0,0,0,0,0,mlb
2004,Toronto Blue Jays,67,94,0.416,40,41,27,53,0,0,0,0,0,0,0,0,mlb
2003,Anaheim Angels,77,85,0.475,45,37,32,48,0,0,0,0,0,0,0,0,mlb
2003,Arizona Diamondbacks,84,78,0.518,45,36,39,42,0,0,0,0,0,0,0,0,mlb
2003,Atlanta Braves,101,61,0.624,55,26,46,35,0,0,0,1,0,0,0,0,mlb
2003,Baltimore Orioles,71,91,0.438,40,40,31,51,0,0,0,0,0,0,0,0,mlb
2003,Boston Red Sox,95,67,0.586,53,28,42,39,0,0,1,0,0,1,0,0,mlb
2003,Chicago Cubs,88,74,0.543,44,37,44,37,0,0,1,0,0,1,0,0,mlb
2003,Chicago White Sox,86,76,0.531,51,30,35,46,0,0,0,0,0,0,0,0,mlb
2003,Cincinnati Reds,69,93,0.426,35,46,34,47,0,0,0,0,0,0,0,0,mlb
2003,Cleveland Indians,68,94,0.42,38,43,30,51,0,0,0,0,0,0,0,0,mlb
2003,Colorado Rockies,74,88,0.457,49,32,25,56,0,0,0,0,0,0,0,0,mlb
2003,Detroit Tigers,43,119,0.265,23,58,20,61,0,0,0,0,0,0,0,0,mlb
2003,Florida Marlins,91,71,0.562,53,28,38,43,0,0,1,0,1,0,1,0,mlb
2003,Houston Astros,87,75,0.537,48,33,39,42,0,0,0,0,0,0,0,0,mlb
2003,Kansas City Royals,83,79,0.512,40,40,43,39,0,0,0,0,0,0,0,0,mlb
2003,Los Angeles Dodgers,85,77,0.525,46,35,39,42,0,0,0,0,0,0,0,0,mlb
2003,Miami Marlins,68,94,0.42,31,50,37,44,0,0,0,0,0,0,0,0,mlb
2003,Minnesota Twins,90,72,0.556,48,33,42,39,0,0,0,1,0,0,0,0,mlb
2003,Montreal Expos,83,79,0.512,52,29,31,50,0,0,0,0,0,0,0,0,mlb
2003,New York Mets,66,95,0.41,34,46,32,49,0,0,0,0,0,0,0,0,mlb
2003,New York Yankees,101,61,0.624,50,32,51,29,0,0,1,0,1,0,1,0,mlb
2003,Oakland Athletics,96,66,0.593,57,24,39,42,0,0,0,1,0,0,0,0,mlb
2003,Philidelphia Phillies,86,76,0.531,49,32,37,44,0,0,0,0,0,0,0,0,mlb
2003,Pittsburgh Pirates,75,87,0.463,39,42,36,45,0,0,0,0,0,0,0,0,mlb
2003,San Dieglo Padres,64,98,0.395,35,46,29,52,0,0,0,0,0,0,0,0,mlb
2003,San Francisco Giants,100,61,0.621,57,24,43,37,0,0,0,1,0,0,0,0,mlb
2003,Seattle Mariners,93,69,0.574,50,31,43,38,0,0,0,0,0,0,0,0,mlb
2003,St. Louis Cardinals,85,77,0.525,48,33,37,44,0,0,0,0,0,0,0,0,mlb
2003,Tampa Bay Devil Rays,63,99,0.389,36,45,27,54,0,0,0,0,0,0,0,0,mlb
2003,Texas Rangers,71,91,0.438,43,38,28,53,0,0,0,0,0,0,0,0,mlb
2003,Toronto Blue Jays,86,76,0.531,41,40,45,36,0,0,0,0,0,0,0,0,mlb
2002,Anaheim Angels,99,63,0.611,54,27,45,36,0,0,1,0,1,0,1,0,mlb
2002,Arizona Diamondbacks,98,64,0.605,55,26,43,38,0,0,0,1,0,0,0,0,mlb
2002,Atlanta Braves,101,59,0.631,52,28,49,31,0,0,0,1,0,0,0,0,mlb
2002,Baltimore Orioles,67,95,0.414,34,47,33,48,0,0,0,0,0,0,0,0,mlb
2002,Boston Red Sox,93,69,0.574,42,39,51,30,0,0,0,0,0,0,0,0,mlb
2002,Chicago Cubs,67,95,0.414,36,45,31,50,0,0,0,0,0,0,0,0,mlb
2002,Chicago White Sox,81,81,0.5,47,34,34,47,0,0,0,0,0,0,0,0,mlb
2002,Cincinnati Reds,78,84,0.481,38,43,40,41,0,0,0,0,0,0,0,0,mlb
2002,Cleveland Indians,74,88,0.457,39,42,35,46,0,0,0,0,0,0,0,0,mlb
2002,Colorado Rockies,73,89,0.451,47,34,26,55,0,0,0,0,0,0,0,0,mlb
2002,Detroit Tigers,55,106,0.342,33,47,22,59,0,0,0,0,0,0,0,0,mlb
2002,Florida Marlins,79,83,0.488,46,35,33,48,0,0,0,0,0,0,0,0,mlb
2002,Houston Astros,84,78,0.518,47,34,37,44,0,0,0,0,0,0,0,0,mlb
2002,Kansas City Royals,62,100,0.383,37,44,25,56,0,0,0,0,0,0,0,0,mlb
2002,Los Angeles Dodgers,92,70,0.568,46,35,46,35,0,0,0,0,0,0,0,0,mlb
2002,Miami Marlins,56,106,0.346,31,50,25,56,0,0,0,0,0,0,0,0,mlb
2002,Minnesota Twins,94,67,0.584,54,27,40,40,0,0,1,0,0,1,0,0,mlb
2002,Montreal Expos,83,79,0.512,49,32,34,47,0,0,0,0,0,0,0,0,mlb
2002,New York Mets,75,86,0.466,38,43,37,43,0,0,0,0,0,0,0,0,mlb
2002,New York Yankees,103,58,0.64,52,28,51,30,0,0,0,1,0,0,0,0,mlb
2002,Oakland Athletics,103,59,0.636,54,27,49,32,0,0,0,1,0,0,0,0,mlb
2002,Philidelphia Phillies,80,81,0.497,40,40,40,41,0,0,0,0,0,0,0,0,mlb
2002,Pittsburgh Pirates,72,89,0.447,38,42,34,47,0,0,0,0,0,0,0,0,mlb
2002,San Dieglo Padres,66,96,0.407,41,40,25,56,0,0,0,0,0,0,0,0,mlb
2002,San Francisco Giants,95,66,0.59,50,31,45,35,0,0,1,0,1,0,0,1,mlb
2002,Seattle Mariners,93,69,0.574,48,33,45,36,0,0,0,0,0,0,0,0,mlb
2002,St. Louis Cardinals,97,65,0.599,52,29,45,36,0,0,1,0,0,1,0,0,mlb
2002,Tampa Bay Devil Rays,55,106,0.342,30,51,25,55,0,0,0,0,0,0,0,0,mlb
2002,Texas Rangers,72,90,0.444,42,39,30,51,0,0,0,0,0,0,0,0,mlb
2002,Toronto Blue Jays,78,84,0.481,42,39,36,45,0,0,0,0,0,0,0,0,mlb
2001,Anaheim Angels,75,87,0.463,39,42,36,45,0,0,0,0,0,0,0,0,mlb
2001,Arizona Diamondbacks,92,70,0.568,48,33,44,37,0,0,1,0,1,0,1,0,mlb
2001,Atlanta Braves,88,74,0.543,40,41,48,33,0,0,1,0,0,1,0,0,mlb
2001,Baltimore Orioles,63,98,0.391,30,50,33,48,0,0,0,0,0,0,0,0,mlb
2001,Boston Red Sox,82,79,0.509,41,40,41,39,0,0,0,0,0,0,0,0,mlb
2001,Chicago Cubs,88,74,0.543,48,33,40,41,0,0,0,0,0,0,0,0,mlb
2001,Chicago White Sox,83,79,0.512,46,35,37,44,0,0,0,0,0,0,0,0,mlb
2001,Cincinnati Reds,66,96,0.407,27,54,39,42,0,0,0,0,0,0,0,0,mlb
2001,Cleveland Indians,91,71,0.562,44,36,47,35,0,0,0,1,0,0,0,0,mlb
2001,Colorado Rockies,73,89,0.451,41,40,32,49,0,0,0,0,0,0,0,0,mlb
2001,Detroit Tigers,66,96,0.407,37,44,29,52,0,0,0,0,0,0,0,0,mlb
2001,Florida Marlins,76,86,0.469,46,34,30,52,0,0,0,0,0,0,0,0,mlb
2001,Houston Astros,93,69,0.574,44,37,49,32,0,0,0,1,0,0,0,0,mlb
2001,Kansas City Royals,65,97,0.401,35,46,30,51,0,0,0,0,0,0,0,0,mlb
2001,Los Angeles Dodgers,86,76,0.531,44,37,42,39,0,0,0,0,0,0,0,0,mlb
2001,Miami Marlins,68,94,0.42,36,45,32,49,0,0,0,0,0,0,0,0,mlb
2001,Minnesota Twins,85,77,0.525,47,34,38,43,0,0,0,0,0,0,0,0,mlb
2001,Montreal Expos,68,94,0.42,34,47,34,47,0,0,0,0,0,0,0,0,mlb
2001,New York Mets,82,80,0.506,44,37,38,43,0,0,0,0,0,0,0,0,mlb
2001,New York Yankees,95,65,0.594,51,28,44,37,0,0,1,0,1,0,0,1,mlb
2001,Oakland Athletics,102,60,0.63,53,28,49,32,0,0,0,1,0,0,0,0,mlb
2001,Philidelphia Phillies,86,76,0.531,47,34,39,42,0,0,0,0,0,0,0,0,mlb
2001,Pittsburgh Pirates,62,100,0.383,38,43,24,57,0,0,0,0,0,0,0,0,mlb
2001,San Dieglo Padres,79,83,0.488,35,46,44,37,0,0,0,0,0,0,0,0,mlb
2001,San Francisco Giants,90,72,0.556,49,32,41,40,0,0,0,0,0,0,0,0,mlb
2001,Seattle Mariners,116,46,0.716,57,24,59,22,0,0,1,0,0,1,0,0,mlb
2001,St. Louis Cardinals,93,69,0.574,54,28,39,41,0,0,0,1,0,0,0,0,mlb
2001,Tampa Bay Devil Rays,62,100,0.383,37,44,25,56,0,0,0,0,0,0,0,0,mlb
2001,Texas Rangers,73,89,0.451,41,41,32,48,0,0,0,0,0,0,0,0,mlb
2001,Toronto Blue Jays,80,82,0.494,40,42,40,40,0,0,0,0,0,0,0,0,mlb
2000,Anaheim Angels,82,80,0.506,46,35,36,45,0,0,0,0,0,0,0,0,mlb
2000,Arizona Diamondbacks,85,77,0.525,47,34,38,43,0,0,0,0,0,0,0,0,mlb
2000,Atlanta Braves,95,67,0.586,51,30,44,37,0,0,0,1,0,0,0,0,mlb
2000,Baltimore Orioles,74,88,0.457,44,37,30,51,0,0,0,0,0,0,0,0,mlb
2000,Boston Red Sox,85,77,0.525,42,39,43,38,0,0,0,0,0,0,0,0,mlb
2000,Chicago Cubs,65,97,0.401,38,43,27,54,0,0,0,0,0,0,0,0,mlb
2000,Chicago White Sox,95,67,0.586,46,35,49,32,0,0,0,1,0,0,0,0,mlb
2000,Cincinnati Reds,85,77,0.525,43,38,42,39,0,0,0,0,0,0,0,0,mlb
2000,Cleveland Indians,90,72,0.556,48,33,42,39,0,0,0,0,0,0,0,0,mlb
2000,Colorado Rockies,82,80,0.506,48,33,34,47,0,0,0,0,0,0,0,0,mlb
2000,Detroit Tigers,79,83,0.488,43,38,36,45,0,0,0,0,0,0,0,0,mlb
2000,Florida Marlins,79,82,0.491,43,38,36,44,0,0,0,0,0,0,0,0,mlb
2000,Houston Astros,72,90,0.444,39,42,33,48,0,0,0,0,0,0,0,0,mlb
2000,Kansas City Royals,77,85,0.475,42,39,35,46,0,0,0,0,0,0,0,0,mlb
2000,Los Angeles Dodgers,86,76,0.531,44,37,42,39,0,0,0,0,0,0,0,0,mlb
2000,Miami Marlins,73,89,0.451,42,39,31,50,0,0,0,0,0,0,0,0,mlb
2000,Minnesota Twins,69,93,0.426,36,45,33,48,0,0,0,0,0,0,0,0,mlb
2000,Montreal Expos,67,95,0.414,37,44,30,51,0,0,0,0,0,0,0,0,mlb
2000,New York Mets,94,68,0.58,55,26,39,42,0,0,1,0,1,0,0,1,mlb
2000,New York Yankees,87,74,0.54,44,36,43,38,0,0,1,0,1,0,1,0,mlb
2000,Oakland Athletics,91,70,0.565,47,34,44,36,0,0,0,1,0,0,0,0,mlb
2000,Philidelphia Phillies,65,97,0.401,34,47,31,50,0,0,0,0,0,0,0,0,mlb
2000,Pittsburgh Pirates,69,93,0.426,37,44,32,49,0,0,0,0,0,0,0,0,mlb
2000,San Dieglo Padres,76,86,0.469,41,40,35,46,0,0,0,0,0,0,0,0,mlb
2000,San Francisco Giants,97,65,0.599,55,26,42,39,0,0,0,1,0,0,0,0,mlb
2000,Seattle Mariners,91,71,0.562,47,34,44,37,0,0,1,0,0,1,0,0,mlb
2000,St. Louis Cardinals,95,67,0.586,50,31,45,36,0,0,1,0,0,1,0,0,mlb
2000,Tampa Bay Devil Rays,69,92,0.429,36,44,33,48,0,0,0,0,0,0,0,0,mlb
2000,Texas Rangers,71,91,0.438,42,39,29,52,0,0,0,0,0,0,0,0,mlb
2000,Toronto Blue Jays,83,79,0.512,45,36,38,43,0,0,0,0,0,0,0,0,mlb
1999,Anaheim Angels,70,92,0.432,37,44,33,48,0,0,0,0,0,0,0,0,mlb
1999,Arizona Diamondbacks,100,62,0.617,52,29,48,33,0,0,0,1,0,0,0,0,mlb
1999,Atlanta Braves,103,59,0.636,56,25,47,34,0,0,1,0,1,0,0,1,mlb
1999,Baltimore Orioles,78,84,0.481,41,40,37,44,0,0,0,0,0,0,0,0,mlb
1999,Boston Red Sox,94,68,0.58,49,32,45,36,0,0,1,0,0,1,0,0,mlb
1999,Chicago Cubs,67,95,0.414,34,47,33,48,0,0,0,0,0,0,0,0,mlb
1999,Chicago White Sox,75,86,0.466,38,42,37,44,0,0,0,0,0,0,0,0,mlb
1999,Cincinnati Reds,96,67,0.589,45,37,51,30,0,0,0,0,0,0,0,0,mlb
1999,Cleveland Indians,97,65,0.599,47,34,50,31,0,0,0,1,0,0,0,0,mlb
1999,Colorado Rockies,72,90,0.444,39,42,33,48,0,0,0,0,0,0,0,0,mlb
1999,Detroit Tigers,69,92,0.429,38,43,31,49,0,0,0,0,0,0,0,0,mlb
1999,Florida Marlins,64,98,0.395,35,45,29,53,0,0,0,0,0,0,0,0,mlb
1999,Houston Astros,97,65,0.599,50,32,47,33,0,0,0,1,0,0,0,0,mlb
1999,Kansas City Royals,64,97,0.398,33,47,31,50,0,0,0,0,0,0,0,0,mlb
1999,Los Angeles Dodgers,77,85,0.475,37,44,40,41,0,0,0,0,0,0,0,0,mlb
1999,Miami Marlins,74,87,0.46,32,48,42,39,0,0,0,0,0,0,0,0,mlb
1999,Minnesota Twins,63,97,0.394,31,50,32,47,0,0,0,0,0,0,0,0,mlb
1999,Montreal Expos,68,94,0.42,35,46,33,48,0,0,0,0,0,0,0,0,mlb
1999,New York Mets,97,66,0.595,49,32,48,34,0,0,1,0,0,1,0,0,mlb
1999,New York Yankees,98,64,0.605,48,33,50,31,0,0,1,0,1,0,1,0,mlb
1999,Oakland Athletics,87,75,0.537,52,29,35,46,0,0,0,0,0,0,0,0,mlb
1999,Philidelphia Phillies,77,85,0.475,41,40,36,45,0,0,0,0,0,0,0,0,mlb
1999,Pittsburgh Pirates,78,83,0.484,45,36,33,47,0,0,0,0,0,0,0,0,mlb
1999,San Dieglo Padres,74,88,0.457,46,35,28,53,0,0,0,0,0,0,0,0,mlb
1999,San Francisco Giants,86,76,0.531,49,32,37,44,0,0,0,0,0,0,0,0,mlb
1999,Seattle Mariners,79,83,0.488,43,38,36,45,0,0,0,0,0,0,0,0,mlb
1999,St. Louis Cardinals,75,86,0.466,38,42,37,44,0,0,0,0,0,0,0,0,mlb
1999,Tampa Bay Devil Rays,69,93,0.426,33,48,36,45,0,0,0,0,0,0,0,0,mlb
1999,Texas Rangers,95,67,0.586,51,30,44,37,0,0,0,1,0,0,0,0,mlb
1999,Toronto Blue Jays,84,78,0.518,40,41,44,37,0,0,0,0,0,0,0,0,mlb
1998,Anaheim Angels,85,77,0.525,42,39,43,38,0,0,0,0,0,0,0,0,mlb
1998,Arizona Diamondbacks,65,97,0.401,34,47,31,50,0,0,0,0,0,0,0,0,mlb
1998,Atlanta Braves,106,56,0.654,56,25,50,31,0,0,1,0,0,1,0,0,mlb
1998,Baltimore Orioles,79,83,0.488,42,39,37,44,0,0,0,0,0,0,0,0,mlb
1998,Boston Red Sox,92,70,0.568,51,30,41,40,0,0,0,1,0,0,0,0,mlb
1998,Chicago Cubs,90,73,0.552,51,31,39,42,0,0,0,1,0,0,0,0,mlb
1998,Chicago White Sox,80,82,0.494,44,37,36,45,0,0,0,0,0,0,0,0,mlb
1998,Cincinnati Reds,77,85,0.475,39,42,38,43,0,0,0,0,0,0,0,0,mlb
1998,Cleveland Indians,89,73,0.549,46,35,43,38,0,0,1,0,0,1,0,0,mlb
1998,Colorado Rockies,77,85,0.475,42,39,35,46,0,0,0,0,0,0,0,0,mlb
1998,Detroit Tigers,65,97,0.401,32,49,33,48,0,0,0,0,0,0,0,0,mlb
1998,Florida Marlins,54,108,0.333,31,50,23,58,0,0,0,0,0,0,0,0,mlb
1998,Houston Astros,102,60,0.63,55,26,47,34,0,0,0,1,0,0,0,0,mlb
1998,Kansas City Royals,72,89,0.447,29,51,43,38,0,0,0,0,0,0,0,0,mlb
1998,Los Angeles Dodgers,83,79,0.512,48,33,35,46,0,0,0,0,0,0,0,0,mlb
1998,Miami Marlins,74,88,0.457,38,43,36,45,0,0,0,0,0,0,0,0,mlb
1998,Minnesota Twins,70,92,0.432,35,46,35,46,0,0,0,0,0,0,0,0,mlb
1998,Montreal Expos,65,97,0.401,39,42,26,55,0,0,0,0,0,0,0,0,mlb
1998,New York Mets,88,74,0.543,47,34,41,40,0,0,0,0,0,0,0,0,mlb
1998,New York Yankees,114,48,0.704,62,19,52,29,0,0,1,0,1,0,1,0,mlb
1998,Oakland Athletics,74,88,0.457,39,42,35,46,0,0,0,0,0,0,0,0,mlb
1998,Philidelphia Phillies,75,87,0.463,40,41,35,46,0,0,0,0,0,0,0,0,mlb
1998,Pittsburgh Pirates,69,93,0.426,40,40,29,53,0,0,0,0,0,0,0,0,mlb
1998,San Dieglo Padres,98,64,0.605,54,27,44,37,0,0,1,0,1,0,0,1,mlb
1998,San Francisco Giants,89,74,0.546,49,32,40,42,0,0,0,0,0,0,0,0,mlb
1998,Seattle Mariners,76,85,0.472,42,39,34,46,0,0,0,0,0,0,0,0,mlb
1998,St. Louis Cardinals,83,79,0.512,48,34,35,45,0,0,0,0,0,0,0,0,mlb
1998,Tampa Bay Devil Rays,63,99,0.389,33,48,30,51,0,0,0,0,0,0,0,0,mlb
1998,Texas Rangers,88,74,0.543,48,33,40,41,0,0,0,1,0,0,0,0,mlb
1998,Toronto Blue Jays,88,74,0.543,51,30,37,44,0,0,0,0,0,0,0,0,mlb